7;6;2;4;8;1190;1191;1194;1313;1366;1600;1635;1865;1864;1867;1868;1312;0;10;1;5;2120;1188;1634;2342;2341;2382;1983;2401;2626;2627;2376;1866;2861;3011;3013;9;20;3558;1311;2416;3687;3686;2347;3788;3792;3789;2019;3791;3790;3794;3638;2758;3847;3;4050;4049;4053;4052;4051;
182;184;189;191;190;188;185;187;1274;1307;1308;1310;1516;1601;1833;1949;1963;1309;2062;2197;2315;2316;2325;2326;1306;2334;1515;2821;183;2864;3087;3085;3086;3084;3590;3579;2317;3680;3678;3679;181;3802;3804;3803;3800;3795;3797;3805;186;3806;3807;3796;2327;3798;
192;193;925;927;924;922;1035;2161;2160;2320;2322;2588;2321;923;2972;2970;2971;2969;2825;3297;
31;26;27;29;24;34;35;69;70;1174;1187;68;1178;1288;1303;1338;1394;1521;1395;1862;1959;1960;1962;1961;2021;2024;2139;1179;25;2386;1202;2399;1175;1304;1680;71;2436;1954;1321;28;3015;23;3088;2143;3450;2421;2404;1186;3580;3563;3556;3562;3593;3594;3595;1863;3642;2140;3673;2020;3674;3671;32;3801;3564;3820;3821;3849;3855;3819;3845;3844;1302;3875;3014;36;3876;3127;4034;1203;4022;1872;4026;
55;63;62;65;56;58;61;1176;1201;1287;1286;67;1396;1409;1519;1811;1812;1813;1958;2009;2008;2022;2141;2166;2359;2333;60;2381;59;2390;2344;2420;1200;2419;2423;1884;2487;1284;2868;2345;3452;64;3560;3588;3567;3566;3584;3646;3641;3717;3585;3985;3986;3987;2867;4023;4031;66;4266;4267;4268;
83;82;81;77;78;80;195;199;1080;1195;74;1192;1193;1238;1424;1337;1426;1442;1528;206;1839;1882;1951;1950;1952;1986;2032;2156;76;2202;196;1529;2335;2402;2398;73;1315;2414;2415;1318;1953;2378;2157;72;2418;616;2488;2805;2804;2375;2806;84;2866;2397;1081;2137;1317;2158;3553;1197;3672;79;3720;3719;3718;1803;3770;1196;3856;75;3881;3869;3868;3867;3565;3983;3991;3984;1283;2117;4239;4258;
197;200;205;201;204;219;220;1228;1425;1441;1440;1576;1841;1847;240;2031;2138;2252;2256;1430;198;2338;2490;2245;2662;202;2671;2669;2740;1439;2845;1229;3010;1681;3438;3436;3437;1443;1227;242;2614;2615;1840;224;1225;2489;2251;2670;3515;3514;3521;2201;3516;3518;3783;3769;3773;2030;3866;3862;3863;241;3861;203;4218;4219;4234;4192;2741;4257;4248;4254;4255;4253;4256;4249;4240;4252;4251;4238;4241;4243;4242;4245;1572;4246;4244;4247;4250;
107;110;103;101;104;1314;143;108;1336;1637;1638;1885;1886;1955;2128;2150;2154;1214;2371;2361;2369;109;2383;1639;2394;2392;2393;2395;2144;2408;2407;2406;1282;2501;2370;2750;2149;2854;159;2838;2837;142;141;100;105;106;3989;102;4032;
147;148;149;150;146;1294;1293;1222;1437;95;1547;1957;1956;2148;477;2360;2354;2349;2353;2348;145;2350;2409;2760;2352;151;2413;3294;2761;2391;96;2351;156;1296;3561;3591;2011;3601;1082;3659;3349;2412;4073;2356;4068;4069;4064;2759;4061;4063;2355;4195;4196;4199;4198;4197;4194;4188;4220;
170;180;2410;176;2625;175;173;2762;1059;2850;2849;161;3365;2833;136;3355;3359;174;179;177;178;3600;
112;113;114;139;1063;111;140;1217;1215;1509;116;1508;1510;1615;1893;2013;2056;2169;1064;2362;2365;2368;2167;2605;138;2624;115;2835;2168;2859;1612;3339;2015;160;2823;2012;3554;3341;3573;3569;
53;127;129;132;126;1183;1182;1061;1216;1444;1065;1728;1834;1890;1891;1892;2063;2064;2133;2152;2151;128;2363;2364;2366;1295;1887;2751;2818;2820;2834;2855;2819;2856;3296;124;3471;3574;2314;1066;3643;3644;125;3645;1305;3676;3675;52;3990;
1084;2250;2645;2643;2644;2994;3155;230;3224;228;229;3372;2002;2853;225;2852;2247;221;222;2337;227;2336;1226;2695;2332;1713;2863;2851;1716;2636;2842;223;3373;226;1632;3517;3217;3771;3786;1756;3860;243;4054;2248;4202;1996;4206;4212;4213;4214;4205;4204;4203;2697;
328;332;335;339;350;1413;1411;1412;1496;1763;1908;1916;1777;336;1495;1918;2474;330;2528;2527;2524;337;1778;2663;1762;1410;2704;2703;2705;1764;2717;2765;2706;338;2798;2800;2797;2918;1919;3031;334;3096;2799;3103;2475;329;3282;3284;3283;351;3348;2523;3418;2766;1555;333;4005;1909;4044;4045;4043;4047;
327;310;309;340;354;353;1418;1556;1609;352;1685;1911;1910;361;2072;1650;326;2534;324;2728;2730;2727;1686;3037;2053;3117;3116;2729;2473;3118;3460;2504;3455;2502;341;3482;1647;3493;3036;
252;254;255;245;244;246;247;1237;1379;1560;1578;1804;1805;2051;1428;1236;2503;2533;2635;1378;2634;1691;2638;2637;2862;2915;251;2937;2997;2996;250;3102;253;3109;3101;3110;3111;2998;3226;3228;3229;1377;3227;3522;3523;1906;3528;248;3766;3768;3767;
265;258;1429;1561;1871;263;264;261;194;257;2403;2417;2803;2241;2844;2935;2934;1563;2980;2843;1698;3345;1562;2536;3346;1699;3097;2240;1688;3073;1697;262;266;3500;1564;3651;3688;2242;3793;3799;2507;267;2936;4001;4002;
272;288;285;289;1490;1492;1493;1494;1251;292;1489;293;291;1497;1922;1924;2046;1491;2660;273;1920;2773;290;2659;2774;2529;3040;3041;3048;3423;3420;3422;3421;287;3973;3972;3971;286;4004;4006;
321;318;319;323;320;1500;325;1559;1849;1904;2324;1703;2472;317;2532;2531;2522;322;2530;2700;2715;1905;2785;2999;2471;3419;1558;1234;2249;1851;249;1235;3225;3526;2244;3785;3763;3784;1557;4048;4046;4042;
300;302;305;306;312;362;365;307;367;360;1256;1461;1462;1481;308;301;1642;1852;1854;1926;1927;1928;1935;2090;2089;2088;1929;2919;303;2973;1483;3035;3034;3033;3032;1683;1684;1480;3053;3052;3049;2075;2087;3477;
342;344;345;346;349;348;377;1416;1417;1610;1611;1646;1648;1649;1861;1914;1915;1912;1917;1933;1934;2216;2220;2217;2453;356;2454;379;2460;2612;2611;2716;355;381;2801;1913;1548;2914;2913;2932;1574;3030;373;3056;3055;3336;3342;2767;1643;3457;2221;3456;3479;3478;3480;3481;1645;1644;378;3483;2610;3486;3488;3487;3490;3335;3980;3981;343;
370;388;389;1470;1472;2448;2447;2449;390;369;2734;2732;1809;2456;2812;2811;2450;3104;3427;3054;3489;
398;399;400;409;408;407;406;404;405;1432;1695;1696;1761;1995;1760;402;2459;1473;2458;397;403;401;2908;2912;2911;372;3026;2665;3344;2909;3347;2506;3440;3439;2910;3485;2769;3491;2457;4090;
701;706;1266;1722;1724;704;1791;1790;2269;1268;2430;703;2479;2478;2484;1269;2477;2589;2632;1797;702;2792;697;2794;1739;2875;2872;2672;3070;3114;3210;708;3405;3406;1740;
728;729;730;1708;1707;1792;2077;1499;2906;2899;2898;731;3083;3082;1941;2080;2131;2078;2581;1942;1793;1712;3194;2900;3548;2079;732;2580;3654;
699;769;1277;1938;2274;724;2585;2683;3027;1737;3063;3071;3399;1937;770;3058;765;768;725;766;2587;771;3065;1731;1729;2870;3059;3060;2480;2129;751;3326;2874;2586;752;1730;3511;1276;3546;
744;745;742;743;741;739;1711;1710;1736;1795;1794;2262;2263;2261;2594;2579;2576;1709;2483;2901;3205;2266;3384;3385;3386;3387;2584;734;1249;2577;735;3195;3545;2578;3544;740;3655;
764;772;773;774;763;1278;1447;1518;1211;1945;1982;1981;2428;2676;1474;3064;3208;3190;3189;2086;2677;3174;3324;1514;3323;1946;3175;2779;3213;762;2302;775;3173;753;3184;2682;2780;
791;792;793;794;795;800;1204;1205;1207;1208;1209;1210;1281;1397;1742;1801;1900;2136;2135;2171;2285;2283;2287;1455;1454;1206;3214;799;3322;796;3508;3502;3503;3319;3501;3512;2784;3937;3936;3940;3935;3938;3957;3939;
777;778;779;759;781;1358;1362;1446;780;1457;1732;1733;1734;1735;1943;2084;2085;2258;2303;2482;2571;1944;2795;2788;2787;3066;3067;761;3181;3177;3211;1261;3186;2678;3176;3182;3212;2265;3178;3183;3188;2130;2796;3397;776;3395;3187;760;2781;2083;3504;3510;
829;845;844;832;830;833;834;835;841;860;1421;1420;1419;1448;1452;1450;2004;2181;2183;2184;2186;2179;2178;2177;843;2330;842;2434;831;2065;1605;2432;3317;3318;3315;3313;3314;3312;3074;1606;1423;2964;1902;1422;3077;3316;849;3537;3535;3534;1607;2182;3910;3883;3882;3886;3885;3898;3890;2500;3903;3902;3905;3908;3904;3909;3912;3911;3913;3927;3907;3906;3914;3916;3929;3915;3887;3888;3889;2433;3884;2329;4037;
837;838;859;863;857;1507;1599;1903;2003;2025;2027;2096;2191;836;2331;2604;2603;864;2630;2095;2642;2648;858;2963;2962;2961;2958;2960;839;2975;2977;2978;2959;2098;3163;3162;2097;3378;3375;3377;3376;3374;3164;3928;3076;3970;3960;3930;3959;3968;3969;3961;3966;3965;2026;2976;3964;3963;3962;
1212;804;914;1408;798;1746;2566;802;2923;2927;2924;2175;2539;3156;2565;801;2281;2282;2925;1453;3321;1748;2922;805;806;2280;3506;3505;3507;1445;3956;3954;3955;3951;3950;3949;3958;3952;3953;2023;3948;3947;3941;797;
817;887;892;2194;2196;2424;2426;889;886;2570;2950;2951;2954;3304;2953;2575;884;2949;885;2952;879;3311;1971;2441;2547;890;2425;2437;893;1596;2438;3495;3494;3541;3542;888;3715;3716;3714;2439;3918;3920;3922;
852;1580;2574;3305;3306;1579;855;2599;2596;2600;2601;897;2598;3166;2597;3079;905;898;875;874;876;1604;2966;854;850;3075;840;851;
856;1975;3092;906;3090;3170;3169;3167;3168;3171;3081;1591;3172;3078;2569;3161;
468;469;470;474;473;472;484;504;503;2114;2113;475;2609;2607;478;3240;2608;3001;3364;3360;476;3366;3361;486;485;1566;1835;487;3410;489;1346;488;490;3234;2107;2892;1384;2649;1524;1613;464;2711;2991;2497;2984;2990;471;3242;3002;
514;506;516;1614;2112;2116;2115;2461;515;507;3241;3237;3238;517;505;3235;591;2110;592;2111;600;3099;3098;594;2876;1674;1673;1342;593;3331;2894;599;3332;3333;3239;
615;932;617;621;620;619;596;622;618;3354;3352;3353;3351;3350;3358;623;4056;4057;4058;4060;4059;601;2893;584;598;1675;
585;624;625;581;582;1159;1158;583;1658;1657;586;580;1665;1660;1667;1677;1676;1875;1659;3006;3007;3143;3144;3145;626;3251;3257;3254;3264;3265;3252;3253;1666;1654;2652;589;590;1765;2869;3260;2109;3250;1664;587;3334;3266;1662;3465;3258;1663;2192;3468;3142;4130;4131;588;4139;
523;520;510;1784;1810;2466;2464;2498;521;2651;1783;2657;3261;498;2463;2099;2629;501;518;2106;1530;2108;3236;2105;502;2104;2650;613;3249;3624;2465;4137;1766;4153;4163;4162;4160;
560;553;557;532;552;662;1550;1551;2123;2294;2296;2297;2469;2468;555;2943;2942;2944;3119;2467;3268;3246;554;3245;3269;2295;3472;2470;3633;3636;558;2298;3635;1679;4164;4159;4169;
213;214;449;1233;212;1343;1381;1567;1842;1894;2038;2037;2039;2119;2205;2210;448;2647;2702;215;2742;425;1570;216;2203;2986;450;3137;3138;3218;3219;2207;3276;3275;3415;1478;3411;1344;3232;2253;1088;2982;1620;3216;1230;235;234;1385;426;3711;3772;3782;1838;3827;3277;3829;2493;4201;4215;4231;4226;4232;
424;419;417;422;423;1242;483;1382;1625;416;1626;1624;1754;1752;1755;1771;1770;421;2118;420;2291;2691;2945;3122;2946;3123;1320;2690;3272;2712;3618;3637;3613;3616;3614;3615;3133;1753;3661;3662;3663;2692;3670;3668;418;3667;3669;3681;3682;3612;3696;3698;3693;3692;3697;3691;3690;3689;1757;3664;3832;3838;3836;3835;3833;2036;4177;4172;4176;4174;4175;
545;544;542;543;538;539;541;540;1326;1324;1327;1330;1402;608;1630;1629;1899;1987;1989;1990;2714;536;2810;546;3431;3429;2048;3430;1325;3435;1988;534;3141;1350;533;2288;511;1678;1785;1328;2809;527;2289;526;1898;1506;535;3513;2047;3619;3621;3620;1628;3640;3132;2049;3684;1767;3702;1323;3708;3707;3709;1329;3745;3750;3751;3746;1351;3749;3741;3752;3742;3748;3747;3753;3758;3759;3760;3639;4014;537;4012;4015;4011;1403;3131;4151;
1140;1142;550;1143;636;1246;1247;1340;1389;1390;1388;1387;1621;1843;635;2939;2940;1391;1386;2941;1150;637;3656;1141;3658;2938;3997;3998;3996;3995;3992;3993;3994;551;4094;4097;4096;4095;
674;677;676;673;672;670;671;679;680;678;683;682;681;684;685;686;666;667;665;664;668;663;669;1768;2058;2060;2094;2091;2093;2227;2226;2225;2236;2229;2237;2230;2228;2232;2235;2233;2238;2239;2234;2718;2722;2724;2719;2723;2726;2720;2725;3017;675;3018;2223;3019;2059;3023;2231;3287;3288;3286;3285;3289;3291;3290;3292;2721;2092;687;3383;3382;
934;1028;935;936;937;940;938;939;965;964;921;946;942;941;943;1456;
947;945;948;949;950;951;952;953;954;955;957;958;959;956;960;961;962;1458;1505;1546;1829;963;1828;1827;966;1830;1545;2067;967;2974;
968;979;982;983;981;978;970;972;971;975;985;977;974;984;986;987;988;989;990;976;2044;2045;973;969;3108;
993;991;992;995;997;996;998;994;1067;1047;999;414;1460;1014;4055;
1012;1015;1011;1002;1003;1008;1006;1007;1009;1010;1004;1000;1013;1535;1016;1005;1017;1001;1359;1360;782;1361;783;
1027;1025;1026;1024;1023;1021;1022;1029;1030;1020;1032;1031;1034;2066;1018;3967;1019;4036;
1037;1056;1057;1058;1060;1040;1039;929;930;1036;1038;1055;928;3496;3497;
1098;1099;980;1115;1097;1096;1101;1100;1102;1114;1095;1464;1465;1467;1466;2068;1093;
1091;1094;1103;1090;1086;1089;1104;1177;1459;1534;1092;1087;
1168;1169;1170;1167;1166;1165;931;606;607;1171;480;602;2069;509;479;3367;3363;3357;3356;513;3362;508;
1116;1117;1126;1125;1118;1119;1122;1121;1123;1124;1127;690;691;692;1133;1769;2061;2070;2306;2305;2304;2307;1120;3024;689;3057;688;
1105;1109;1112;1111;1128;1221;1113;1107;528;1623;1627;1110;1108;1106;3683;415;3756;1139;4010;
1146;1157;1148;1156;1172;1164;1163;1162;1160;1161;1149;1370;1372;1371;1537;1538;1539;1540;1541;1154;1147;1815;1816;1817;1820;1818;1819;1821;1822;1145;1250;
1033;1054;1041;1053;1049;1050;1051;1218;1292;1052;1220;1517;1687;2308;1048;1043;1044;1046;3811;1045;3809;1042;3808;
630;628;1335;627;631;632;633;634;1155;577;1245;575;574;1349;1348;1353;1354;1367;578;1369;1622;1670;1672;1655;1876;1878;2193;2318;2319;2422;2641;2640;1671;3259;3464;1633;1669;3467;3466;629;3470;576;3647;3649;3648;1368;4147;4145;579;3463;4146;4143;4144;4141;4142;1877;1153;4148;3469;4091;4093;4092;4100;4098;4099;4101;4102;4103;4118;4119;4108;4107;4109;4106;4120;4124;4111;4122;4110;4125;4121;4123;4104;4105;4126;4112;4113;4114;4116;4127;4115;4117;4136;4133;4135;4134;4128;4129;4132;
648;647;649;548;547;549;1331;640;644;639;643;642;650;1334;652;1332;1333;645;1398;1502;1526;1536;1772;1775;1776;1997;1999;1992;1994;641;1998;2686;2687;2688;646;2689;481;2713;1773;2814;1137;2813;2815;1993;3120;638;3368;1138;3381;3379;3380;1549;3432;1845;1243;3433;3498;1399;3710;3712;3713;651;3735;3732;3736;3730;3729;3731;3728;3734;3733;2685;3754;3740;3739;1774;3722;3725;3724;3726;3727;3723;3721;1631;3744;3743;3121;4016;4017;4018;4019;4009;1144;4013;2816;4021;4020;
11;12;13;14;1298;1189;21;22;17;15;1219;49;1431;1433;1531;1602;1636;1808;1870;1947;2312;1832;2311;2339;2343;2400;2385;2384;19;2764;18;2865;2159;3008;3009;1532;3012;2340;3551;3552;1301;3578;3575;3577;3589;3587;1948;3685;48;3816;3813;3812;3814;3815;3586;3858;3846;3841;3843;3842;1300;3557;3873;3874;1173;3872;3576;2028;3871;3870;3880;3879;1299;4030;
50;41;47;16;40;1285;51;1181;46;37;54;1275;1185;1180;1184;44;1392;1393;1434;1520;1807;42;1869;1932;2007;2017;2018;2142;2164;2170;2310;2309;39;2379;1641;2387;2405;2388;2860;3449;3555;43;3559;3582;45;3677;2016;3851;3853;3854;3848;3852;3850;2165;3877;3878;3988;2389;4033;3581;4025;4028;4024;4027;4029;38;4035;2313;4261;4263;4262;4260;4259;4265;4264;
134;118;135;122;121;123;1062;1363;1714;1715;1888;1365;2163;2367;117;2753;2752;2836;2822;2826;2829;2828;2827;2830;1364;2162;130;131;2848;2831;2832;133;2858;2763;2857;119;3298;3299;1511;120;3338;3337;2824;137;1831;1889;
89;91;57;90;93;92;88;97;98;1525;1883;2153;2155;2373;2358;2377;99;86;85;1199;94;1436;2374;2486;2485;2476;2840;2839;2357;3016;2145;3295;1198;3417;3550;1290;3549;2346;3568;3583;1316;87;3857;1435;4187;
438;1319;1322;529;525;1244;437;496;604;597;1404;1640;1897;2213;2211;1896;2496;2495;2709;2707;3130;3414;1985;1780;512;2125;2710;3247;530;3248;1779;531;1984;3434;2299;522;556;2880;2879;614;3222;3233;439;436;524;3631;3627;3630;1603;3704;3706;2126;3757;3761;3762;497;4170;
1070;1073;1072;1071;1068;1078;1074;256;33;1427;1533;2198;1069;1076;1077;1079;2199;3293;2243;3650;3810;30;3818;3817;1075;3859;
788;1213;1405;790;1406;787;786;785;784;1901;2631;789;2747;2748;2749;3320;1291;1802;3509;
908;910;911;1617;912;3160;3028;3157;861;907;3165;2979;862;3159;3158;3982;
823;824;826;828;846;1592;1589;2176;2190;2188;825;2328;2561;2540;2189;2542;1451;2187;3302;1593;2435;822;1582;821;3303;2541;827;1449;3533;3529;3530;3532;3531;3536;3538;3539;3540;2543;3917;3893;3892;3895;3894;3896;3897;3901;3899;3900;3301;3891;
894;877;891;1587;2545;2546;2957;2440;895;899;1972;1598;900;1594;1479;3080;1973;1597;1595;1586;3309;2967;3307;3308;1590;1588;3022;2568;1974;3310;3923;3921;3919;3924;3925;3926;3021;4041;
295;1252;296;299;1487;1253;298;297;281;282;283;1921;1925;2222;2520;2538;2537;284;294;3045;1255;3044;3043;3042;3039;3046;3050;1254;3390;3389;3388;1488;3475;2771;3974;3975;1498;4003;
1486;1484;280;278;313;314;316;311;1608;1682;2323;304;2526;2519;2521;1704;2772;2770;1482;3038;1485;3047;3051;3094;3095;2518;3230;3231;3391;3392;277;3393;2516;2517;315;1690;2639;3100;279;3476;
452;218;217;1619;1374;2043;2257;2445;2444;1571;2701;2888;2981;453;456;3369;3413;2042;1297;210;2985;2658;211;1375;2254;209;1223;1438;1083;1224;208;1373;1577;2246;3000;2204;2494;2492;2618;447;2841;3519;2206;3592;1376;3774;3775;3776;3864;3865;4067;4065;4066;207;1575;2255;4236;4221;4222;4235;4233;2491;4200;4217;4189;4216;4224;4225;4223;3777;4190;
1782;491;595;1347;2102;2100;500;2101;2619;1522;2948;3004;3003;3005;2103;926;3221;499;2215;2200;441;1569;2446;427;442;2889;444;2886;443;1231;3416;2301;1836;445;2005;446;1879;458;457;451;1837;2891;3139;2293;1881;1240;1565;611;463;460;2214;3623;3622;2890;3779;3778;462;3828;1568;4074;461;4227;4228;4229;4230;
1130;1136;1129;1131;1355;1132;661;1134;660;1135;1814;933;1503;1504;1544;1543;1542;1823;1824;1825;1826;2029;3448;3499;1339;
3443;3441;3444;657;654;3112;1844;2817;3446;3447;3445;2224;1501;3442;655;1356;2786;3020;658;656;659;3113;3755;653;3738;3737;
693;2006;694;3068;695;1788;3069;1727;3330;3115;2633;1786;2873;700;2674;1787;707;1723;2673;696;2590;
2902;714;713;1279;3407;1271;2057;3404;715;716;1721;2905;1270;1738;2595;3403;2429;3408;2791;2272;718;2273;1978;2270;3409;1850;3106;2431;2793;1513;719;2591;727;3200;726;1272;712;1939;717;721;2275;3547;720;3652;3653;
710;2268;705;709;2684;2271;711;3199;3198;3400;2675;723;3401;2267;1265;2871;1725;1979;3402;3105;698;1267;2789;2790;1726;2777;1477;722;1936;
3191;2592;3300;3193;2681;748;2264;749;3207;738;747;2260;1798;3072;1799;1401;757;1258;2427;1940;758;3185;2679;756;3396;755;2082;1705;3179;2081;754;1259;1706;2782;1800;1400;1260;1475;2593;3206;2481;2259;3192;746;3180;2680;3543;
2956;1966;2560;1584;1747;2544;1967;3150;820;2558;1583;1581;3451;2555;2180;2556;1968;803;810;1407;2174;2173;2172;2286;809;2559;3934;3933;3151;3945;3944;3946;3943;3942;
3154;896;1970;868;880;1965;882;1585;878;881;2572;871;2563;869;2562;870;2552;872;2965;2554;2185;848;2968;853;2573;2548;2549;2550;2551;813;3398;812;3152;865;1969;866;867;2557;847;2564;2553;3931;3932;873;4040;4039;
2955;3147;808;814;3149;3148;818;1977;819;1796;2278;2926;807;2279;1976;815;1745;2284;1743;2000;816;2001;883;2195;3153;1964;3146;811;2567;944;1744;
2623;919;917;915;2622;1806;913;918;3091;2443;920;2442;3089;903;909;904;2621;901;2620;2602;902;916;4038;
2122;2292;3412;493;2033;428;3273;3124;1241;2878;2035;1239;1781;2884;2885;3140;492;1856;3125;3220;3135;1380;2208;603;2883;2882;2881;482;495;2034;430;2877;2121;3129;3128;1749;2209;3271;3136;434;435;1991;2708;1232;1758;3274;1383;2987;2290;2947;1751;431;1750;3134;1573;494;3617;433;3666;440;1345;3665;429;3700;3703;432;3701;3699;3695;3694;3705;2887;3830;3831;3822;3837;3839;3834;3825;3824;3823;1857;3840;2212;4178;4173;4179;
2452;1759;2451;3107;2802;1554;1469;393;2667;1415;382;383;384;385;392;2736;2931;2775;2656;386;2928;387;376;2219;2218;380;1257;375;3343;374;2505;371;2929;2930;2776;391;396;394;2768;3029;2933;395;3462;2666;1468;3484;3492;1895;347;3978;3979;
2147;144;2146;2380;158;2396;163;2010;2754;2755;2756;2757;154;2014;164;155;171;2411;172;168;2372;2989;2606;467;169;162;1616;3340;3570;3572;3571;157;3596;3598;165;3602;3605;3597;3604;3603;3609;3610;3606;3607;3608;166;3599;167;4070;4071;4072;3611;4184;4183;4180;4181;4182;4185;4186;
2514;271;3425;274;1923;2661;3424;3426;2510;275;276;268;3093;1693;1692;270;269;2513;1527;1694;1702;2668;2508;2783;2525;260;2509;2511;2916;2735;259;1701;2917;3394;1700;2512;3453;3977;3976;2731;3454;2515;4007;3999;4000;4008;
561;3267;1846;563;1651;1661;573;612;1668;571;3255;1656;564;1352;559;605;3244;2076;567;565;3243;1341;1152;562;519;2628;568;2124;566;2499;572;3256;570;1653;3263;1652;3473;3474;569;3634;3632;3626;3625;3628;3629;3262;2127;1151;3657;609;4140;4138;2300;4161;4167;4166;4165;4149;4150;4168;3270;4158;4157;4152;4155;4156;4154;2462;4171;
153;2995;2988;466;2653;2134;2041;2040;2616;454;3370;1873;2617;455;2655;610;2920;2983;2654;465;1523;1880;459;2847;2921;3780;3781;152;1874;4062;2846;1618;4191;4193;
3279;2052;331;1907;1248;239;1717;2055;232;3223;1720;1718;3280;1719;233;2992;236;2808;2054;2807;2646;237;2993;1289;238;2694;2696;2535;3278;3215;2613;231;3461;1357;3520;2693;2737;3524;3527;3525;1085;3660;2699;3764;3787;2050;3826;3126;1848;4211;4237;2698;3765;4210;4209;4208;4207;
3202;3204;1741;2276;1273;2904;2277;1512;2903;736;2582;3329;737;1789;3325;2907;767;1263;3197;3201;2132;2897;1264;2895;2583;1855;2778;1476;3203;2896;733;3328;3209;3061;750;3327;3196;1980;3062;1262;
2733;3428;368;1471;364;1853;358;357;2455;2074;2664;359;3371;1931;1463;363;366;2738;3281;2739;1930;1280;2071;2073;1414;3459;3458;
1860;4075;2746;411;4088;3025;2745;410;2744;4089;1689;1553;4078;413;4077;4076;4087;1552;4083;4086;4085;4084;1859;4081;2743;1858;4082;412;4080;4079;